#################################################################################################################################################################
#@  #   #       #   #     #       #   # #           #   #     #         #     #   # #         #   # #   #     #   # #               #                 #   #     #
### # ### ##### # # # # # # ##### # # # # ####### # # # # ### # ####### # ### ### # # ### ### ### # # # # ### ### # # ### ##### ### # ############### # # # ### #
# # # #   #   # # # # # # #     #   # #   #   #   # # #   #   # #       #   #         #   #       #   # #   #     # # #   #   # #   #     #   #   # #   #   #   #
# # # # ##### # # # ### # ##### ##### ##### # # ### # ##### ### # ####### # ############### # ######### ### # # ### # ##### ### ######### # ### # # ######### ###
# # #         # # #     # # #   #   # #     # # # # # #   # #   # #   #   #     #           #           #   # #           #   #         # #   # # #     #     # #
# # ########### # ####### # # ### # # # ##### # # # # # ### # # # # # # ######### ########################### ####### ### ### ######### # # # # # # # # # ### # #
#   #   #   #     #         #   # # #   #     # #     #     # # #   #           # #     #         #       #   #     # #   # # #       # # # #   # # # # #   # # #
### # # # # # ####### ######### ### ##### ##### ### ### ##### ################# # # ### # ####### # ##### # ##### ### ##### # # ##### # # # ##### # # ##### ### #
#     #   # # #     # #       #   #       #     #   # # #   # #         #       #   #   #       #   #     #   #   #   #   # #   #       # #   #   # # #     #   #
# ######### # ##### ### ### ##### ######### ##### ### # # # # # ####### ############# ########### ### ####### # ### ### # # ##### ### ### ### # ### ### ##### # #
# #   #   # #     #   # # # #   # #   #   # #   #   #   # #   #   #   #             # #     #     # #   #   #   #     # # # # #   #   #   #   # #   #   #     # #
# # # ### # ### ##### # # # # # # # ### # # # # ### ##### ####### ### ############# # # ### # ##### ### # # ##### # # ### # # # ### ### ##### # # ### ### ##### #
#   # #     #     #   #   # # #   #   # #   # #   # #       #   #     # #         # # #   # #   #       # #   #   # #     # # # #     # #     # #   #     #     #
### ### ####### # ### ##### # ##### # # ##### ### # # ### # # # ####### # ####### # # ### # ### # ####### ### # ### ####### # # # ##### # ##### ### # # ####### #
#   #   #       # #   #     #       # # #   #   # #   #   #   # #         # #     #     # #     # #   # # #   # # #   #     #   # #     # # #   # # # # #   #   #
# ### ### ####### # ##### ####### # # ### # ### ####### ####### ######### # # ### ### # ### # ### # # # # # ### # ### # ####### # # # ### # # ### # # ### # ### #
#   #     #       #           # # # #     #       #     #     #     #   # #   #     # #   # #   # # # # # #     #     #   #     #   #   #   # #   # # #   #   # #
# ######### # ##### # ####### # # ############### # ##### ### ##### # # ########### # ### ##### # # # # # ############### # ########### # # ### # # # # ##### ###
#   #   #   #   #   #   #   #   #     #   #     #   #   #   # #   # # #   # #     #   #   #     # # # # # # #       #   # # #     # #   # #     # #   # #   #   #
### # ### ##### # ##### ### ########### # # ### # ### # ### # # ### # ### # # ### ##### ### ##### # # # # # # ##### ### # # ##### # # ########### # # # # ##### #
# # # #   #   #   #   #     #     #   # #   # # # # # #   # # #     #   #       #       #   #   # # #     #   #   #       #   # # #     #   #       #   #       #
# # # # ### # ##### # ### ### ### # # # # ### # # # # ### # # ######### ##### # ######### ### # # # ########### # ##### ##### # # ####### ### ### ########### ###
#   #   #   #     # #   #   # #   # #   #   #   # # # # # # #       #   #     #   #   #   #   # # # #       #   # #   #       # #       #     #     #       # # #
# ####### ####### # ####### # ##### ####### ##### # # # # # ####### ##### ####### # # # # ### # # # # ##### # ### # ########### ####### ####### ##### ##### # # #
#     #   #   #     #       #           #   #   # #     # # #     #     # #     #   #   # #   # # #   #   # # #   # #         #     #   #     # #     #     #   #
##### # ### # # ##### ############# ### # ### ### ### ### # # # ####### # ##### ### ####### ### # # # ### # # # ### # ### ### # ##### ### # # # ##### # ####### #
#     #   # # #   # #     #     # #   # #   #   #   # #   #   #   #     #   #   #   #       # # # # # #   #   #   #   # #   #   #   #     # # # #   # #   #   # #
# ####### # # ### # ##### ##### # ### # ### # # ### # # ######### # ####### # ### ### ####### # # # # # ######### ##### ### ### # # ####### # # # # # ### # # ###
# #     # # # #                   #   #   #   #       #   # #     #       #   #   # # #     #   #   #   #       #   #     #   #   #         # #   #   # #   #   #
# ##### # ### # ######### ######### ### ######### # ##### # # ########### # ### ### # # ### ############# ##### ### # ### ### ############### ######### ####### #
#     # # #   # #   #   #           #       #   # # #     # # #   #       #   #   #       #         #   #   # #   # #   # #   #     #       #               #   #
##### # # # ### ### # # ################### # # ### # ##### # # # # ######### ### ################# # # ### # # ### # # # # ### ##### ### # ############### # ###
# #     #   # #   # # #   #           # #   # # #   #     #   # #   #       # #   #         #   #   # #   #   #     # # # #   # # #     # #   #     #   # # #   #
# # # ####### ### # # ### # # ####### # # ##### # ##### # # ### ########### # # ### ####### # ### ### ### ########### # ### ### # # ### ##### # ### ### # # ### #
# # #       #     # # #   # # #     #   # #   # #     # #     # #         #   #   # #     #   #       # #   # #     # #   #   #     #   #   # #   #   # #     # #
# # ####### ##### # # # ### # # ### ##### ### # ##### ######### # ### ### ######### # ### # ### # ##### # # # # # # # ### ### ### # # ### # # ####### # ### # # #
#   #         #   # # #   # # # #         #   #       #           #   #   # #     # #   # #     # #     # #   # # #     #   #     # # #   # #         #   # #   #
##### ######### ### ##### # # # # # ####### ### ####### # ######### ####### # ### # ### # ####### # ########### ########### ####### # # ### ############# ##### #
# #   #     #   #         # # # # #       #     #   #   # #   #   #       # #   # # #   # # #   # # #   #         #   #   #         #   #   #       #   #       #
# # ####### # ### # ######### # # ####### # # ### # # ##### # # ######### # ### # # # ### # # # # # # ### # ### # ### # # ############### ##### ### # # ##### ###
#   #     # #     #   #       # # #   #   # # #   # #     # # #       #       # # #   # # # # #   #       #   # # #   # #       #         #     #   # #   # # # #
##### ### # ######### # ######### # # # ##### # ######### # # ####### # ####### # ##### # # # ##### ######### # # # ### ######### ######### ##### ### ### # # # #
#   # #             # # #       # # #   # #     #     #   # # #         #   #   #   #   #   #   #   #         # #   #   #       #         # #     # # #   # #   #
# # # ### ##### ### # # # ##### # # ##### # ##### ##### ### # # ######### # # ##### # # ####### ############### ##### ### ### # ######### # # ##### # # ### #####
# # # #   #     #   # # # #   # # # #   #       #       #   # #       #   #   #   # # #   # #     #           # #   #     #   #           # #     # # #   #     #
# # # # ######### ### # # # # # # # # # ####### ########### # ####### ######### ### # ### # # # # # ######### # # # ################# ##### ##### # # ### ##### #
# #   # #     #   #   #   # # #   # # # #       #   #       #     #   #     # #     #   #   # # #     #   # #   # # #     #           #   # #     #   #   # #   #
# ##### ##### # ### # ##### ####### ### # ####### # # ########### # ### ### # # ##### # ##### # ####### # # ####### # ### # ########### # # # ####### # ### # # #
#     #       #     #     #             #         #   #           #     #       #     #       #         #             #   #             #   #         #       #E#
#################################################################################################################################################################