#############
#@# #   #   #
#   # # # # #
# ### # # # #
#     #   #E#
# ##### #####
#   #       #
#############