##########
# #      #
#   #### #
#E#    #@#
###### ###
#        #
##########